####################
#  #  #       #    #
#  #  #   ##### ####
#  #	  #     #  # 
#  ####   ##  ###  #
#         #    #   #
####   #  ###  #   #
#  #   #   #   # # #
#  #           # # #
#  #     #######   #
#  ####     #    ###  
#     #     #    # #
#     #     ###### #
#  #               # 
#  #         ####  #
#  ########     #  #
#  #            #  #
#  #   ######   ####
#      #          1#
####################
